Warmth Admidst The Snow
A poem reversal by Josh Parsons
Release 1 / Serial number 231231 / Inform 7 v10.1.2 / D

Hearth Road
You are out for a walk, alone, at the break of dawn in your neighborhood. Snow is gently falling from grey and overcast skies, the sun nowhere to be seen. There's a large field gated by a barbed wire fence.

Desert Places accompanies you on your walk.

>examine field
Behind the barbed wire fence is a sparse field, smothered in a smooth blanket of snow, except for a few weeds breaking through. The blanket of snow stretches past the field and into a wooded area.

Looking upon the stillness, sparseness, and emptiness of the snow, Desert Places reminds you of old memories. Of evening meals back when you used to return home.

* * *

Warmth Admidst The Snow
A poem reversal by Josh Parsons
Release 1 / Serial number 231231 / Inform 7 v10.1.2 / D

Hearth Road
You are out for a walk, alone, at the break of dawn in your neighborhood. Snow is gently falling from grey and overcast skies, the sun nowhere to be seen. There's a large field gated by a barbed wire fence.

Desert Places accompanies you on your walk.

>i
You are carrying:
  a coat (being worn)

>x coat
Your familiar coat. Heavy and somehow never able to completely warm you.

* * *

Warmth Admidst The Snow
A poem reversal by Josh Parsons
Release 1 / Serial number 231231 / Inform 7 v10.1.2 / D

Hearth Road
You are out for a walk, alone, at the break of dawn in your neighborhood. Snow is gently falling from grey and overcast skies, the sun nowhere to be seen. There's a large field gated by a barbed wire fence.

Desert Places accompanies you on your walk.

>pour knit cap into coat
The knit cap cannot be poured into the coat.

>pour coat into knit cap
The coat cannot be poured into the knit cap.

>pour coat into Desert Places
The coat cannot be poured into Desert Places.

>pick up Desert Places
I don't suppose Desert Places would care for that.

* * *

>l
Hearth Road
When you snap back from the memory, you take in the stillness and expressionlessness of the field and the woods, as the snow gently falls and a cold breeze blows across your body.

None of them are in your life. You had to do that, to create that space, but the scars and the bitterness remain. Desert Places interjects with some self-doubt, unable to let go of the moment, "Was that the only option I had?" You process the self-doubt and counter with another thought, "The constant questioning though. The pressure to conform. I'm not going to endure that. Fuck that."

You continue down Hearth Road and notice some of the stars in the sky fading into morning light.

>restart
Are you sure you want to restart?

>y
Warmth Admidst The Snow
A poem reversal by Josh Parsons
Release 1 / Serial number 231230 / Inform 7 v10.1.2 / D

Hearth Road
You are out for a walk, alone, at the break of dawn in your neighborhood. Snow is gently falling from grey and overcast skies, the sun nowhere to be seen. There's a large field gated by a barbed wire fence.

Desert Places accompanies you on your walk.

>rules
Rules tracing now switched on. Type "rules off" to switch it off again, or "rules all" to include even rules which do not apply.

[Rule "parse command rule" applies.]

* * *

>look around
You can't see any such thing.

* * *

>open pot
You open the small steaming pot.

>close pot
You close the small steaming pot.

>insert ladle into pot
The small steaming pot is closed.

* * *

>restart
Are you sure you want to restart?

* * *

>y
Warmth Admidst The Snow
A poem reversal by Josh Parsons
Release 1 / Serial number 231230 / Inform 7 v10.1.2 / D

Hearth Road
You are out for a walk, alone, at the break of dawn in your neighborhood. Snow is gently falling from grey and overcast skies, the sun nowhere to be seen. There's a large field gated by a barbed wire fence.

Desert Places accompanies you on your walk.

>x field
Behind the barbed wire fence is a sparse field, smothered in a smooth blanket of snow, except for a few weeds breaking through. The blanket of snow stretches past the field and into a wooded area.

Looking upon the stillness, sparseness, and emptiness of the snow, Desert Places reminds you of old memories, of evening meals back when you used to return home.

>think about evening meals
As you gaze into the blank white snow, you remember the white tablecloth that covered your family's dining room table. Your mind drifts to the last time you visited them and... that meal.

Dining Room Table - some years ago
You are seated at a large rectangular dining table of stained cherry wood. A large window across from you peers out into the back yard. Outside, daylight is fading and snow is driving down in a tempestuous fury. You feel the room's vent blasting very warm air into the back of your head.

A plain and thin white tablecloth covers the tabletop. On the table, assorted silverware and serving dishes are neatly laid out. Unlit candles span down the spine of the table. In front of you is a bowl of chicken noodle soup, a salad in a salad bowl, and a dinner plate with slices of ham, potatoes, and mixed vegetables. Next to your dinner plate rest a salad fork, a dinner fork, a knife, and a spoon.

Parent One, Parent Two, Relative One, and Sibling One are seated around the table. Desert Places is still with you in your mind as you relive this moment.

There is a quiet stillness in the air. A tension that something is about to start, but hasn't yet.

Hearth Road
You are out for a walk, alone, at the break of dawn in your neighborhood. Snow is gently falling from grey and overcast skies, the sun nowhere to be seen. There's a large field gated by a barbed wire fence.

Desert Places accompanies you on your walk.

>showme coat
coat - thing
location: in End of the Universe
unlit, inedible, fixed in place, scenery; singular-named, improper-named
description: "Your familiar coat. Heavy and somehow never able to completely warm you."
initial appearance: none
printed name: "coat"
printed plural name: none
indefinite article: none
list grouping key: none

>restart
Are you sure you want to restart?

* * *

>y
Warmth Admidst The Snow
A poem reversal by Josh Parsons
Release 1 / Serial number 231230 / Inform 7 v10.1.2 / D

Hearth Road
You are out for a walk, alone, at the break of dawn in your neighborhood. Snow is gently falling from grey and overcast skies, the sun nowhere to be seen. There's a large field gated by a barbed wire fence.

Desert Places accompanies you on your walk.

>actions
Actions listing on.

>x field
[examining the field]
Behind the barbed wire fence is a sparse field, smothered in a smooth blanket of snow, except for a few weeds breaking through. The blanket of snow stretches past the field and into a wooded area.

Looking upon the stillness, sparseness, and emptiness of the snow, Desert Places reminds you of old memories, of evening meals back when you used to return home.

[examining the field - succeeded]

>think about evening meals
[thinking about Evening Meals]
[(1) examining Evening Meals]
As you gaze into the blank white snow, you remember the white tablecloth that covered your family's dining room table. Your mind drifts to the last time you visited them and... that meal.

[(1) examining Evening Meals - succeeded]

[thinking about Evening Meals - succeeded]

[looking]
Dining Room Table - some years ago
You are seated at a large rectangular dining table of stained cherry wood. A large window across from you peers out into the back yard. Outside, daylight is fading and snow is driving down in a tempestuous fury. You feel the room's vent blasting very warm air into the back of your head.

A plain and thin white tablecloth covers the tabletop. On the table, assorted silverware and serving dishes are neatly laid out. Unlit candles span down the spine of the table. In front of you is a bowl of chicken noodle soup, a salad in a salad bowl, and a dinner plate with slices of ham, potatoes, and mixed vegetables. Next to your dinner plate rest a salad fork, a dinner fork, a knife, and a spoon.

Parent One, Parent Two, Relative One, and Sibling One are seated around the table. Desert Places is still with you in your mind as you relive this moment.

There is a quiet stillness in the air. A tension that something is about to start, but hasn't yet.

[looking - succeeded]

[looking]
Hearth Road
You are out for a walk, alone, at the break of dawn in your neighborhood. Snow is gently falling from grey and overcast skies, the sun nowhere to be seen. There's a large field gated by a barbed wire fence.

Desert Places accompanies you on your walk.

[looking - succeeded]

>restart
[restarting the game]
Are you sure you want to restart?

>y
Warmth Admidst The Snow
A poem reversal by Josh Parsons
Release 1 / Serial number 231230 / Inform 7 v10.1.2 / D

Hearth Road
You are out for a walk, alone, at the break of dawn in your neighborhood. Snow is gently falling from grey and overcast skies, the sun nowhere to be seen. There's a large field gated by a barbed wire fence.

Desert Places accompanies you on your walk.

* * *

>rules
Rules tracing now switched on. Type "rules off" to switch it off again, or "rules all" to include even rules which do not apply.

[Rule "parse command rule" applies.]

>x field
[Rule "declare everything initially unmentioned rule" applies.]
[Rule "generate action rule" applies.]
[Rule "announce items from multiple object lists rule" applies.]
[Rule "set pronouns from items from multiple object lists rule" applies.]
[Rule "before stage rule" applies.]
[Rule "basic visibility rule" applies.]
[Rule "can't act in the dark rule" applies.]
[Rule "basic accessibility rule" applies.]
[Rule "carrying requirements rule" applies.]
[Rule "instead stage rule" applies.]
[Rule "requested actions require persuasion rule" applies.]
[Rule "carry out requested actions rule" applies.]
[Rule "descend to specific action-processing rule" applies.]
[Rule "work out details of specific action rule" applies.]
[Rule "investigate player's awareness before action rule" applies.]
[Rule "player aware of his own actions rule" applies.]
[Rule "check stage rule" applies.]
[Rule "carry out stage rule" applies.]
[Rule "Carry out examining something" applies.]
[Rule "standard examining rule" applies.]
Behind the barbed wire fence is a sparse field, smothered in a smooth blanket of snow, except for a few weeds breaking through. The blanket of snow stretches past the field and into a wooded area.

Looking upon the stillness, sparseness, and emptiness of the snow, Desert Places reminds you of old memories, of evening meals back when you used to return home.

[Rule "examine directions rule" applies.]
[Rule "examine containers rule" applies.]
[Rule "examine supporters rule" applies.]
[Rule "examine devices rule" applies.]
[Rule "examine undescribed things rule" applies.]
[Rule "after stage rule" applies.]
[Rule "investigate player's awareness after action rule" applies.]
[Rule "report stage rule" applies.]
[Rule "report other people examining rule" applies.]
[Rule "last specific action-processing rule" applies.]
[Rule "A first turn sequence rule" applies.]
[Rule "scene change machinery rule" applies.]
[Rule "every turn stage rule" applies.]
[Rule "timed events rule" applies.]
[Rule "advance time rule" applies.]
[Rule "update chronological records rule" applies.]
[Rule "A last turn sequence rule" applies.]
[Rule "scene change machinery rule" applies.]
[Rule "adjust light rule" applies.]
[Rule "note object acquisitions rule" applies.]
[Rule "notify score changes rule" applies.]
[Rule "parse command rule" applies.]

* * *

>showme Remembering the Dining Room
There seems to be no such object anywhere in the model world.

* * *

Warmth Admidst The Snow
A poem reversal by Josh Parsons
Release 1 / Serial number 231231 / Inform 7 v10.1.2 / D

Hearth Road
You are out for a walk, alone, at the break of dawn in your neighborhood. Snow is gently falling from grey and overcast skies, the sun nowhere to be seen. There's a large field gated by a barbed wire fence.

Desert Places accompanies you on your walk.

>test test-full
>--> The following tests are available:
'test walk-test'
'test dining-room-test'
'test full-test'

* * *

Warmth Admidst The Snow
A poem reversal by Josh Parsons
Release 1 / Serial number 231231 / Inform 7 v10.1.2 / D

Hearth Road
You are out for a walk, alone, at the break of dawn in your neighborhood. Snow is gently falling from grey and overcast skies, the sun nowhere to be seen. There's a large field gated by a barbed wire fence.

Desert Places accompanies you on your walk.

>x desert places
You see nothing special about Desert Places.

>desert places, follow me
Desert Places has better things to do.

>desert places, stop following me
Desert Places has better things to do.

>x field
Behind the barbed wire fence is a sparse field, smothered in a smooth blanket of snow, except for a few weeds breaking through. The blanket of snow stretches past the field and into a wooded area.

Looking upon the stillness, sparseness, and emptiness of the snow, Desert Places reminds you of old memories. Of evening meals back when you used to return home.

* * *

>x desert places
You see nothing special about Desert Places.

>x hearth road
You can't see any such thing.

* * *

Warmth Admidst The Snow
A poem reversal by Josh Parsons
Release 1 / Serial number 231231 / Inform 7 v10.1.2 / D

Hearth Road
You are out for a walk, alone, at the break of dawn in your neighborhood. Snow is gently falling from grey and overcast skies, the sun nowhere to be seen. There's a large field gated by a barbed wire fence.

Desert Places accompanies you on your walk.

>x field
Behind the barbed wire fence is a sparse field, smothered in a smooth blanket of snow, except for a few weeds breaking through. The blanket of snow stretches past the field and into a wooded area.

Looking upon the stillness, sparseness, and emptiness of the snow, Desert Places reminds you of old memories, of evening meals back when you used to return home.

* * *

>showme player
There seems to be no such object anywhere in the model world.

>showme me
yourself - person
location: in Hearth Road
unlit, inedible, portable; transparent, male; singular-named, proper-named
description: "As good-looking as ever."
initial appearance: none
carrying capacity: 100
printed name: "yourself"
printed plural name: "people"
indefinite article: none
list grouping key: none

>showme coat
coat - thing
location: in End of the Universe
unlit, inedible, fixed in place, scenery; singular-named, improper-named
description: none
initial appearance: none
printed name: "coat"
printed plural name: none
indefinite article: none
list grouping key: none

* * *

>x desert places
You see nothing special about Desert Places.

* * *

>x field
Behind the barbed wire fence is a sparse field, smothered in a smooth blanket of snow, except for a few weeds breaking through. The blanket of snow stretches past the field and into a wooded area.

Looking upon the stillness, sparseness, and emptiness of the snow, Desert Places reminds you of old memories, of evening meals back when you used to return home.

>x evening meals
As you gaze into the blank white snow, you remember the white tablecloth that covered your family's dining room table. Your mind drifts to the last time you visited them and... that meal.

Dining Room Table - some years ago
You are seated at a large rectangular dining table of stained cherry wood. A large window across from you peers out into the back yard. Outside, daylight is fading and snow is driving down in a tempestuous fury. You feel the room's vent blasting very warm air into the back of your head.

A plain and thin white tablecloth covers the tabletop. On the table, assorted silverware and serving dishes are neatly laid out. Unlit candles span down the spine of the table. In front of you is a bowl of chicken noodle soup, a salad in a salad bowl, and a dinner plate with slices of ham, potatoes, and mixed vegetables. Next to your dinner plate rest a salad fork, a dinner fork, a knife, and a spoon.

Parent One, Parent Two, Relative One, and Sibling One are seated around the table. Desert Places is still with you in your mind as you relive this moment.

There is a quiet stillness in the air. A tension that something is about to start, but hasn't yet.

You can see a coat here.

Hearth Road
You are out for a walk, alone, at the break of dawn in your neighborhood. Snow is gently falling from grey and overcast skies, the sun nowhere to be seen. There's a large field gated by a barbed wire fence.

Desert Places accompanies you on your walk.

>x tablecloth
Freshly pressed for the occasion, all of its folds and wrinkles have been smoothed out. Plain white, white as snow, with no art or decoration or frills to speak up. No life or charm. You remember that the table had intricate, hand-carved floral patterns atop the table. Now it is smothered by the plain, snow white tablecloth.

>x soup
Chicken noodle soup. Most likely completely absent of any seasoning or flavor. The bowl is full of a yellow-tinted broth, with small pale noodles floating to the surface, and small cubes of pale chicken.

>eat soup
(with the spoon)
That's plainly inedible.

>i
You are carrying:
  a spoon

* * *

Warmth Admidst The Snow
A poem reversal by Josh Parsons
Release 1 / Serial number 231231 / Inform 7 v10.1.2 / D

Hearth Road
You are out for a walk, alone, at the break of dawn in your neighborhood. Snow is gently falling from grey and overcast skies, the sun nowhere to be seen. There's a large field gated by a barbed wire fence.

Desert Places accompanies you on your walk.

>x fields
You can't see any such thing.

>x field
Behind the barbed wire fence is a sparse field, smothered in a smooth blanket of snow, except for a few weeds breaking through. The blanket of snow stretches past the field and into a wooded area.

Looking upon the stillness, sparseness, and emptiness of the snow, Desert Places reminds you of old memories. Of evening meals back when you used to return home.

* * *

Warmth Admidst The Snow
A poem reversal by Josh Parsons
Release 1 / Serial number 231231 / Inform 7 v10.1.2 / D

Hearth Road
You are out for a walk, alone, at the break of dawn in your neighborhood. Snow is gently falling from grey and overcast skies, the sun nowhere to be seen. There's a large field gated by a barbed wire fence.

Desert Places accompanies you on your walk.

>x test-full
You can't see any such thing.

>test test-full
>--> The following tests are available:
'test walk-test'
'test dining-room-test'
'test full-test'